11111111111111111
1C10C100000000C11
10000101100010001
10100V01111111100
1P100C0000C0E00E1
11111111111111111
