11111111111111111
1C10C100000000C11
10000101101010001
10100V01111111101
1P10CCCCCCCCCCCE1
11111111111111111
